8 6
-1 -1 25 24 1 0 
28 27 26 23 2 3 
29 30 21 22 5 4 
32 31 20 7 6 -1 
33 -1 19 8 9 10 
34 -1 18 -1 -1 11 
35 36 17 -1 13 12 
38 37 16 15 14 -1 
9 7
52 -1 -1 -1 4 3 2 
51 50 49 6 5 0 1 
46 47 48 7 18 19 20 
45 -1 9 8 17 22 21 
44 -1 10 11 16 23 24 
43 42 41 12 15 -1 25 
38 39 40 13 14 27 26 
37 34 33 32 29 28 -1 
36 35 -1 31 30 -1 -1 
10 8
-1 28 29 30 -1 -1 39 40 
26 27 -1 31 32 33 38 41 
25 24 23 22 21 34 37 42 
12 13 16 17 20 35 36 43 
11 14 15 18 19 0 1 44 
10 7 6 5 4 3 2 45 
9 8 57 56 55 54 53 46 
-1 -1 58 59 -1 -1 52 47 
67 66 65 60 61 -1 51 48 
68 -1 64 63 62 -1 50 49 
10 8
-1 -1 48 49 50 51 -1 61 
45 46 47 -1 53 52 -1 60 
44 41 40 39 54 55 -1 59 
43 42 -1 38 -1 56 57 58 
0 11 12 37 36 35 34 33 
1 10 13 14 15 30 31 32 
2 9 8 17 16 29 -1 -1 
3 6 7 18 19 28 27 26 
4 5 -1 -1 20 21 24 25 
-1 -1 -1 -1 -1 22 23 -1 
11 9
-1 8 9 12 13 24 25 26 27 
6 7 10 11 14 23 22 -1 28 
5 4 -1 -1 15 16 21 20 29 
-1 3 2 1 0 17 18 19 30 
-1 40 39 38 37 36 -1 32 31 
-1 41 -1 -1 -1 35 34 33 -1 
43 42 -1 -1 67 68 69 70 71 
44 45 46 -1 66 65 64 63 72 
-1 48 47 -1 -1 -1 61 62 73 
50 49 -1 -1 56 57 60 -1 74 
51 52 53 54 55 58 59 -1 75 
12 10
-1 -1 -1 19 20 -1 -1 53 54 55 
-1 -1 -1 18 21 -1 -1 52 51 56 
10 11 -1 17 22 23 24 -1 50 57 
9 12 15 16 27 26 25 48 49 58 
8 13 14 -1 28 45 46 47 60 59 
7 6 -1 30 29 44 43 62 61 -1 
0 5 32 31 38 39 42 63 64 -1 
1 4 33 36 37 40 41 -1 65 66 
2 3 34 35 -1 -1 -1 -1 -1 67 
-1 -1 85 84 -1 76 75 74 -1 68 
-1 -1 86 83 82 77 78 73 -1 69 
89 88 87 -1 81 80 79 72 71 70 
13 11
-1 -1 -1 -1 52 53 -1 -1 -1 -1 80 
-1 -1 49 50 51 54 -1 -1 -1 -1 79 
-1 47 48 -1 56 55 -1 -1 76 77 78 
-1 46 -1 -1 57 60 61 -1 75 -1 -1 
-1 45 -1 -1 58 59 62 -1 74 73 -1 
43 44 -1 22 21 -1 63 -1 -1 72 -1 
42 -1 24 23 20 -1 64 -1 -1 71 -1 
41 26 25 -1 19 -1 65 66 -1 70 -1 
40 27 28 29 18 17 16 67 68 69 -1 
39 -1 -1 30 31 -1 15 14 1 2 -1 
38 35 34 33 32 -1 12 13 0 3 4 
37 36 -1 -1 -1 -1 11 10 9 6 5 
-1 -1 -1 -1 -1 -1 -1 -1 8 7 -1 
14 12
48 49 50 51 116 117 118 119 120 127 128 129 
47 54 53 52 115 114 113 112 121 126 125 -1 
46 55 -1 61 62 63 64 111 122 123 124 -1 
45 56 57 60 -1 66 65 110 109 108 -1 -1 
44 -1 58 59 68 67 -1 -1 -1 107 106 -1 
43 -1 75 74 69 -1 95 96 -1 -1 105 -1 
42 77 76 73 70 93 94 97 -1 -1 104 -1 
41 78 79 72 71 92 -1 98 99 100 103 -1 
40 81 80 89 90 91 -1 -1 -1 101 102 -1 
39 82 83 88 23 22 -1 -1 -1 4 5 -1 
38 -1 84 87 24 21 20 19 2 3 6 -1 
37 36 85 86 25 -1 -1 18 1 0 7 -1 
34 35 30 29 26 -1 -1 17 14 13 8 9 
33 32 31 28 27 -1 -1 16 15 12 11 10 
14 12
-1 -1 81 80 79 78 77 76 75 74 73 72 
-1 -1 82 -1 50 51 -1 -1 60 61 62 71 
89 88 83 84 49 52 -1 -1 59 64 63 70 
90 87 86 85 48 53 -1 -1 58 65 66 69 
91 92 45 46 47 54 55 56 57 -1 67 68 
94 93 44 37 36 35 34 33 -1 -1 -1 -1 
95 -1 43 38 39 -1 31 32 -1 -1 -1 -1 
96 97 42 41 40 29 30 -1 -1 -1 -1 -1 
99 98 -1 -1 -1 28 -1 6 7 -1 -1 -1 
100 -1 -1 -1 26 27 4 5 8 -1 -1 -1 
101 -1 105 106 25 24 3 2 9 -1 -1 -1 
102 103 104 107 108 23 0 1 10 11 12 13 
117 116 113 112 109 22 21 -1 17 16 15 14 
118 115 114 111 110 -1 20 19 18 -1 -1 -1 
14 12
14 15 16 17 18 19 20 21 22 -1 -1 125 
13 2 3 4 -1 -1 -1 24 23 -1 123 124 
12 1 0 5 -1 31 30 25 -1 -1 122 -1 
11 10 9 6 -1 32 29 26 -1 -1 121 120 
40 39 8 7 34 33 28 27 -1 -1 -1 119 
41 38 37 36 35 86 87 88 91 92 -1 118 
42 51 52 53 54 85 84 89 90 93 -1 117 
43 50 49 48 55 82 83 -1 95 94 115 116 
44 45 46 47 56 81 80 -1 96 -1 114 113 
-1 -1 61 60 57 78 79 -1 97 98 99 112 
-1 -1 62 59 58 77 76 -1 -1 101 100 111 
-1 -1 63 68 69 70 75 -1 103 102 -1 110 
-1 -1 64 67 -1 71 74 -1 104 107 108 109 
-1 -1 65 66 -1 72 73 -1 105 106 -1 -1 
14 12
125 114 113 112 95 94 93 90 89 88 87 86 
124 115 -1 111 96 97 92 91 -1 81 82 85 
123 116 117 110 109 98 99 0 79 80 83 84 
122 119 118 -1 108 101 100 1 78 77 76 75 
121 120 -1 106 107 102 3 2 -1 72 73 74 
12 11 -1 105 104 103 4 -1 -1 71 -1 -1 
13 10 9 8 7 6 5 -1 -1 70 69 -1 
14 15 16 25 26 -1 -1 -1 -1 67 68 -1 
-1 18 17 24 27 -1 47 48 65 66 -1 -1 
-1 19 20 23 28 -1 46 49 64 63 -1 -1 
-1 -1 21 22 29 44 45 50 51 62 61 60 
-1 -1 -1 -1 30 43 42 -1 52 53 54 59 
-1 -1 -1 -1 31 32 41 40 39 38 55 58 
-1 -1 -1 -1 -1 33 34 35 36 37 56 57 
14 12
-1 -1 -1 -1 -1 100 101 102 107 108 109 116 
-1 -1 -1 -1 -1 99 98 103 106 111 110 115 
-1 -1 -1 -1 95 96 97 104 105 112 113 114 
-1 -1 -1 -1 94 93 -1 -1 10 11 12 13 
-1 -1 -1 -1 91 92 -1 -1 9 -1 15 14 
86 87 88 89 90 -1 -1 -1 8 -1 16 17 
85 82 81 0 1 2 -1 -1 7 -1 -1 18 
84 83 80 79 78 3 4 5 6 21 20 19 
59 60 61 62 77 -1 -1 -1 -1 22 23 24 
58 57 64 63 76 75 74 -1 -1 -1 -1 25 
55 56 65 66 67 -1 73 72 31 30 29 26 
54 49 48 -1 68 69 70 71 32 33 28 27 
53 50 47 -1 -1 42 41 40 39 34 35 -1 
52 51 46 45 44 43 -1 -1 38 37 36 -1 
14 12
-1 -1 -1 -1 -1 -1 -1 -1 -1 -1 82 83 
-1 -1 -1 -1 65 66 69 70 71 80 81 84 
18 19 20 -1 64 67 68 -1 72 79 -1 85 
17 -1 21 62 63 -1 -1 74 73 78 87 86 
16 23 22 61 60 59 -1 75 76 77 88 -1 
15 24 -1 -1 -1 58 -1 -1 -1 -1 89 -1 
14 25 28 29 30 57 -1 -1 -1 -1 90 -1 
13 26 27 0 31 56 -1 -1 -1 -1 91 92 
12 3 2 1 32 55 54 53 -1 -1 94 93 
11 4 5 -1 33 34 51 52 -1 96 95 -1 
10 7 6 -1 -1 35 50 49 48 97 98 -1 
9 8 -1 -1 37 36 -1 46 47 -1 99 100 
-1 -1 -1 -1 38 41 42 45 -1 -1 -1 101 
-1 -1 -1 -1 39 40 43 44 -1 -1 -1 102 
14 12
28 29 30 -1 -1 -1 -1 -1 44 45 46 -1 
27 -1 31 32 39 40 41 42 43 -1 47 -1 
26 -1 -1 33 38 37 -1 67 66 -1 48 -1 
25 -1 -1 34 35 36 -1 68 65 50 49 -1 
24 -1 -1 -1 -1 -1 70 69 64 51 54 55 
23 -1 -1 -1 -1 72 71 62 63 52 53 56 
22 21 20 19 -1 73 -1 61 60 59 58 57 
5 6 17 18 -1 74 75 -1 -1 -1 -1 -1 
4 7 16 15 14 -1 76 -1 -1 -1 -1 -1 
3 8 -1 -1 13 -1 77 80 81 82 -1 -1 
2 9 10 11 12 -1 78 79 -1 83 84 -1 
1 104 103 102 -1 -1 -1 94 93 92 85 86 
0 105 106 101 -1 -1 -1 95 -1 91 88 87 
109 108 107 100 99 98 97 96 -1 90 89 -1 
14 12
111 110 109 108 107 -1 -1 -1 -1 -1 -1 -1 
-1 -1 -1 -1 106 105 102 101 98 97 96 -1 
-1 -1 13 12 11 104 103 100 99 -1 95 94 
16 15 14 -1 10 9 8 7 -1 -1 -1 93 
17 -1 -1 46 47 -1 5 6 -1 -1 -1 92 
18 -1 -1 45 48 3 4 59 60 -1 -1 91 
19 -1 -1 44 49 2 1 58 61 -1 89 90 
20 -1 42 43 50 51 0 57 62 -1 88 87 
21 -1 41 40 -1 52 55 56 63 -1 -1 86 
22 -1 -1 39 -1 53 54 -1 64 -1 84 85 
23 24 37 38 -1 -1 -1 66 65 -1 83 82 
-1 25 36 35 -1 -1 -1 67 76 77 78 81 
27 26 -1 34 33 -1 69 68 75 74 79 80 
28 29 30 31 32 -1 70 71 72 73 -1 -1 
14 12
117 -1 -1 -1 107 106 -1 -1 -1 -1 -1 -1 
116 -1 110 109 108 105 -1 -1 -1 -1 -1 -1 
115 112 111 30 29 104 103 -1 -1 -1 -1 -1 
114 113 32 31 28 101 102 -1 -1 85 84 -1 
-1 -1 33 26 27 100 -1 -1 -1 86 83 -1 
-1 -1 34 25 -1 99 92 91 90 87 82 81 
-1 -1 35 24 23 98 93 94 89 88 -1 80 
42 41 36 37 22 97 96 95 6 5 78 79 
43 40 39 38 21 20 19 -1 7 4 77 76 
44 45 46 -1 -1 17 18 9 8 3 -1 75 
49 48 47 -1 15 16 11 10 -1 2 73 74 
50 51 -1 -1 14 13 12 63 64 1 72 -1 
-1 52 53 56 57 -1 61 62 65 0 71 70 
-1 -1 54 55 58 59 60 -1 66 67 68 69 
14 12
-1 -1 -1 -1 -1 -1 25 26 27 102 103 106 
-1 17 18 19 20 21 24 29 28 101 104 105 
-1 16 15 -1 -1 22 23 30 -1 100 99 98 
12 13 14 -1 -1 35 34 31 -1 -1 -1 97 
11 10 9 8 -1 36 33 32 -1 -1 -1 96 
2 1 0 7 38 37 -1 -1 -1 -1 -1 95 
3 4 5 6 39 -1 43 44 -1 -1 -1 94 
-1 -1 -1 -1 40 41 42 45 -1 -1 -1 93 
-1 62 61 60 -1 52 51 46 -1 -1 91 92 
-1 63 58 59 -1 53 50 47 -1 89 90 -1 
65 64 57 56 55 54 49 48 -1 88 -1 -1 
66 -1 -1 -1 -1 -1 -1 77 78 87 86 85 
67 68 -1 -1 73 74 75 76 79 -1 -1 84 
-1 69 70 71 72 -1 -1 -1 80 81 82 83 
